NO ./tex/bricks.xpm
SO ./tex/bricks.xpm
WE ./tex/bricks.xpm
EA ./tex/bricks.xpm

S ./path_to_the_east_texture 55 55

W ././path_to_the_east_texture

S ./path_to_the_east_texture 66 66 

D ./path_to_the_east_texture

E ./path_to_the_east_texture

F 28,134,238
C 225,30,0

1111111111111111111111
1000000000000000000001
100000000W000000000001
1000000000000000000001
1000000000000000000001
1000000000000000000001
1000000000000000000001
1000000000000000000001
1000000000000000000001
1000000000000000000001
1000010000001100000001
1000000000000000000001
1000000000000000000001
1000000111111111110001
1000011111111111110001
1000011000000111110001
1111110000000000111111
