NO ./path_to_the_north_texture
SO ./path_to_the_south_texture
WE ./path_to_the_west_texture
EA ./path_to_the_east_texture

F 0, 255,0

C  0,0, 255

 111111111111111111111111111111111111111111111111111111111111111111111111111
1S00000000000000000000000000000000000000000000000000000000000000000000000001
1000000000000000000000000000000000000000000000000000000000000000000000000001
 111111111111111111111111111111111111111111111111111111111111111111100000001
                                                                   100000001
                                                                   100000001
                                                                   100000001
                                                                   100000001
                                                                   100000001
                                                                   100000001
                                                                   100000001
                                                                   100000001
                                                                   100000001
                                                                   100000001
                                                                   100000001
                                                                   100000001
                                                                   100000001        111111111111111111
                                                                   100000001        100000000000000001
1111111111111111111111111111111111111111111111111111111111111111111100000001        100000000000000001
1000000000000100000010000000010000000001000000000001000000000100000000000001        111111111111110001
1000000000000100000010000000010000000001000000000001000000000100000000000001                     10001
1000000000000100100010000100010000100001000001000001000001000100010000000001                     10001
1000000000000000100000000100000000100000000001000000000001000000010000000001                     10001
1000000000000000100000000100000000100000000001000000000001000000010000000001                     10001
1111111111111111111111111111111111111111111111111111111111111111111100000001                     10001
                                                                   100000001                     10001
                                                                   100000001                     10001
                                                                   100000001                     10001
                                                                   100000001                     10001
                                                                   100000001                     10001
                                                                   100000001       111111111     10001
                                                                   100000001      10000000001    10001
                                                                   100000001     1000011100001   10001
                                                                   100000001    100011   110001  10001
                                                                   100000001   10011       10011 10001
                                                                   100000001  1001          1000110001
                                                                   100000001 1001            100010001
                                                                   10000000110001             10000001
                                                                   1000000000001               1000001
                                                                   1000000000001               1000001
                                                                   1000000000001               1000001
                                                                   10000000110001             10000001
                                                                   100000001 1001            100000001
                                                                   100000001  10011         1100110001
1111111111111111111111111111111111111111111111111111111111111111111100000001   100011     110001 10001111111
1000000000000000000000000000000000000000000000000000000000000000000000000001    100001111100001  10000000001
1000000000000000000000000000000000000000000000000000000000000000000000000001     1100000000011   10000000001
1111111111111111111111111111111111111111111111111111111111111111111111111111       111111111     11111111111
