NO ./path_to_the_north_texture
SO ./path_to_the_south_texture
WE ./path_to_the_west_texture
EA ./path_to_the_east_texture

S ./path_to_the_east_texture 55 55

W ././path_to_the_east_texture

S ./path_to_the_east_texture 66 66 

D ./path_to_the_east_texture

E ./path_to_the_east_texture

F 28,134,238
C 225,30,0

1111111111111111111111
1000000000000000000001
1000000000000000000001
1000000000000000000001
1000111111111111110001
1000111111111111110001
1000111111111111110001
1000111111111111110001
1000111111111111110001
1000111111111111110001
1000000000000000000001
1000000000000000000001
1111111111111111110001
1000000111111111110001
1110011111111111110N01
1110011111111111110001
1111111111111111111111
