NO ./tex/brick_wall.xpm
SO ./tex/brick_wall.xpm
WE ./tex/brick_wall.xpm
EA ./tex/brick_wall.xpm

S ./path_to_the_east_texture 55 55

W ././path_to_the_east_texture

S ./path_to_the_east_texture 66 66 

D ./path_to_the_east_texture

E ./path_to_the_east_texture

F 22,22,22
C 0,10,222

1111111111111111111111
1000000000000000000001
101000000W000000100001
1000000000000000000001
1000111111111111110001
10001            10001
10001            10001
10001            10001
10001            10001
1000111111111111110001
1000010100001100000001
1000000000010000000001
1000000000000000000001
1000000111111111110001
1110011111111111110001
1110011      111110001
111111          111111
