NO ./path_to_the_north_texture
SO ./path_to_the_south_texture
WE ./path_to_the_west_texture
EA ./path_to_the_east_texture

S ./path_to_the_east_texture 55 55

W ././path_to_the_east_texture

S ./path_to_the_east_texture 66 66 

D ./path_to_the_east_texture

E ./path_to_the_east_texture

F 255,255, 255
C 225,30,0

1111111111111111111111
1000000000000000000001
1000000000000000000001
1000000000000000000001
1000111111111111110001
10001            10001
10001            10001
1000111111111111110001
1000000000000000000001
1000000000000000000001
1111111111111111110001
10000001         10001
11100111         10N01
11100111         10001
11111111          111
