NO ./tex/brick_wall.xpm
SO ./tex/brick-wall-1916752_640.xpm
WE ./tex/bricks.xpm
EA ./tex/gold1.xpm

F 28,134,38
C 22,30,222

         111111111111111111111111111111111111111111111111111
         100000000000000000000000000000000000000000000000001
         100000000000000000000000000000000000000000000000001
         100000000000000000000000000000000000000000000000001
         100000000000000000000000000000000000000000000000001
1111111111000000000000000000000000N0000000000000000000000001
100000000000000000000000000000000000000000000000001111111111
100000000000000000000000000000000000000000000000001
100000000000000000000000000000000000000000000000001
100000000000000000000000000000000000000000000000001
100000000000000000000000000000000000000000000000001
100000000000000000000000000000000000000000000000001
100000000000000000000000000000000000000000000000001
100000000000000000000000000000000000000000000000001
100000000000000000000000000000000000000000000000001
100000000000000000000000000000000000000000000000001
100000000000000000000000000000000000000000000000001
100000000000000000000000000000000000000000000000001
111111111111111111111111111111111111111111111111111
