NO ./tex/brick_wall.xpm
SO ./tex/brick-wall-1916752_640.xpm
WE ./tex/bricks.xpm
EA ./tex/gold1.xpm

F 28,134,38
C 22,30,222


111111111111111111111111111111111111111111111111111
100000000000000000000000000000100000000001111111101
100000000W00000000000111111110001100111101111111101
100000000000000000000111111111001100011101111111101
100000000000000000000111111111111100011101111111101
100000000000000000000111111111111100011101111111101
100000000000000000000111111111111100011101111111101
100000000000000000000111111111111100111101111111101
100000000000000000000000000000000000000000000000001
100000000000000000000000000000000000000000000000001
100000000000000000000111111111111101111111111111111
111111000000111111111100000000000000010000000000001
100000000000000000000000000000000000010000000000001
100000000000000000000111111111111101111111111111111
100000011111111111000111111111111101111111111111111
100001111111111111000100000000000000000000000000001
100001100000011111000100000000000000000000000000001
111111000000000000000111111111111101111111111111111
111111111111111111111111111111111111111111111111111
