NO ./res/tex/wolf_redwall.xpm
SO ./res/tex/wolf_wood.xpm
WE ./res/tex/wolf_stones.xpm
EA ./res/tex/wolf_stonescolored.xpm

F 28,134,38
C 22,30,222

111111111111111111111111111111111
100000000000100000000001111111101
100111111110001100111101111111101
100111111111001100011101111111101
100111111111111100011101111111101
1001111111111111000111S11111111001
100111111111111100011101111111101
100111111111111100111101111111101
100000000000000000000000000000001
100000000000000000000000000011111
100111111111111101111111111111111
111100000000000000010000000000001
100000000000000000010000000000001
100111101111111101111111111111111
100111101111111101111111111111111
100100000011000000000000110000001
100100000011000000000000110000001
100111111111111101111111111111111
111111111111111111111111111111111
